######
#%   #
# _# #
#  0 #
# 0  #
#_   #
######
